0['aba', 'aba', 'aaa', 'aaa']
1['aba', 'aaa', 'aaa', 'aba']
2['aaa', 'aaa', 'aba', 'aba']
3['aaa', 'aba', 'aba', 'aaa']
4['aba', 'aba', 'aba', 'aaa']
5['aba', 'aba', 'aaa', 'aba']
6['aba', 'aaa', 'aba', 'aba']
7['aaa', 'aba', 'aba', 'aba']
8['aaa', 'aaa', 'aaa', 'aaa']
9['aaa', 'aaa', 'aaa', 'aaa']
10['aaa', 'aaa', 'aaa', 'aaa']
11['aaa', 'aaa', 'aaa', 'aaa']
12['aba', 'aba', 'aba', 'aba']
13['aba', 'aba', 'aba', 'aba']
14['aba', 'aba', 'aba', 'aba']
15['aba', 'aba', 'aba', 'aba']